C   0 , 06  , 255
F 000,20,25


R 1500 1200

SO ./assets/xpm/down.xpm
WE ./assets/xpm/left.xpm
EA ./assets/xpm/right2.xpm
NO  ./assets/xpm/up.xpm

S ./assets/xpm/pinpinsmall.xpm

        1111111111111111111111111
        1004000014000000004000401
1111111110111000111022222411110011111111111
1400000040000000700000005063010000000000001
1111111111011111111122222411110011111101111
100000000001400141111100004000401    101
100000000001400140000111110111111    101
1111011111111101112000001000111111111101
1111N11100400001110101001000000000000001
1111111111010101110000001000111111111111
10000000000000000000000010001
10000000000000001101010010001
10000000000000001101010010001
11000001110101011111011110111
11110111 1110101 101111010001
11111111 1111111 111111111111




