C   0 , 06  , 255
F 250,250,250


R 1500 1200

SO ./assets/xpm/down.xpm
WE ./assets/xpm/left.xpm
EA ./assets/xpm/right2.xpm
NO  ./assets/xpm/up.xpm

S ./assets/xpm/pinpinsmall.xpm

11111111111111
 1222222222221
 1000000000001
 1000002000001
 10001W1000001
 1000010000001
 1111111111111